11111111
1E11K1C1
1011C111
1000P0C1
11111111
