11111111
1E1100C1
1K11C111
1000P0C1
11111111
