1111111111
1C1C0000E1
1011110K01
10P0C10KK1
1011110001
100000K1C1
1111111111
