1111111111
1C1C000KE1
1011110K01
10P0C10KK1
1011110001
10000001C1
1111111111
