1111111111
100KEK0001
100KPK0001
100KKK0001
1000000C01
1000000001
1111111111
