11111111
1CCK00E1
1PC10111
10100001
11111111
