1111111111
1CKCKCKCC1
1CCCCCCKC1
1CCCPECCC1
1CKCCCCCC1
1CCCKCCCC1
1111111111
