11111111
1P010CE1
1001C111
101000C1
11111111
