11111111
1P0K0CE1
100KC111
10K000C1
11111111
