11111111
1P1E00C1
1011C111
1000E0C1
11111111