11111111
1P1100C1
        
1011C111
10E000C1
11111111
