11111111
1P1E1 11
10111111
10000011
11111111
