11111111
1C1E00C1
1011C111
100000C1
11111111