1111111111
100E1C0PC1
10111K0001
10000000C1
1111111111