11111111
1P110CK1
10110111
100X00E1
11111111
