11111111
1P1ECK11
10101111
10000011
11111111
