11111111
1P0E0011
10111111
10000K11
11111111
