11111111
1K1E00C1
1011C111
100000C1
11111111
