11111111
1P1100C1
1011C111
100000C1
11111111