11111111
1P1E00C1
1011C111
10000PC1
11111111