11111111
1P1E00K1
1010C111
1000E0C1
11111111
