11111111
1P1\nE11
10111111
10000C11
11111111
