11111111
1P1\nE11
1011K111
10000C11
11111111
