11111111
1P1E1 11
10111111
100K0011
11111111
