11111111
1P1100C1
10110110
100X00E1
11111111
