11111111
1P1E 011
10111111
10000011
11111111
