11111111
1P1/n011
10111111
10000011
11111111
