"11111111"
"1P1E0011"
"10111111"
"10000011"
"11111111"
