11111111
1E1101C1
1011C111
1000P0C1
11111111
