11111111
1CC100E1
1PC10111
10100001
11111111
