11111111
1PC100E1
1CC10111
10100001
11111111
