11111111
1E11KKC1
1011C1K1
1000P0C1
11111111
