1111111111
1K1KE00011
1C1KP01011
1C11C11CC1
1C0001KCK1
1K1K11KKK1
1111111111
