1111111111111111111
1PK0001C1KC01C00001
1001111C111011110K1
1C0000000C000000001
10111011111110111C1
1000000KE000000CK11
1011111110111010011
1K000KC000CKC0C00C1
1111111111111111111
