1111111111
1KCCKCKCK1
1CKCCCCCC1
1CCCPECKC1
1CKCCCCCK1
1KCCKCKCK1
1111111111
