1111111111
1CKCKCKCK1
1KCKCKCKC1
1CKCPEKCK1
1KCKCKCKC1
1CKCKCKCK1
1111111111
