11111111
1P010EC1
1001C111
100000C1
11111111
