11111111
1P010KC1
1001C111
1E0000C1
11111111
