11111111
1P1E00K1
1010C111
10000PC1
11111111
