11101111
1P1100C1
1011C110
1000E0C1
11111111
