11111111
1P1100C1
1011C110
10E000C1
11101111
