11111111
1P1100C1

1011C111
10E000K1
11111111
