11111
1PCK1
10E11
10001
11111
