11111111
1P1ECC11
10100111
10000011
11111111
