01111111
1P1100E1
1011C111
100000K1
11111111
