11101111
1P1100C1
1011C110
1000E0K1
11111111
