11111111"
"1P1E0011"
"10111K11"
"10000011"
"11111111"
