	11111111
	1P1E0011
	10111111
	100000K1
	11111111
