1111111111
100KE00001
100KP0C001
100KKCCC01
10000K0001
100000K001
1111111111
