1111111111
100C1KEPC1
10111K0001
1C00000KC1
1111111111
