1111111111
1KP0K11K11
11K0CK1C11
111K0110K1
1E11000011
1000CK1111
1C10K11CK1
1K10000CK1
1111111111