1111111111
111K11E1K1
1C1KK101K1
1CPCC101K1
1111010001
11C000C1C1
1111111111
