111111111111111111111111111111
101000P00000100000000000000001
1C1011111110C00000000000000001
1010000E1100010000000000000001
101001111100000000000000000001
1010C100C0001C0000000000000001
100000001000000000000000000001
111111111111111111111111111111
111111111111111111111111111111
100000000000000000000000000001
100000000000000000000000000001
100000000000000000000000000001
100000000000000000000000000001
100000000000000000000000000001
100000000000000000000000000001
100000000000000000000000000001
100000000000000000000000000001
100000000000000000000000000001
100000000000000000000000000001
111111111111111111111111111111
