111111111111111
101000P00000101
1C1011111110C01
1010000E1100011
101001111100001
1010C100C0001C1
100000001000001
111111111111111