11111111111111111111
1E1KC00000000000C1C1
101KC10111011111CKC1
10111101110C001KCCC1
100C0001111110111001
11111111P0000011KCK1
1KC00000CK111111KC11
11111111111111111111
