1111111111

1C1C0001E1
1011110101
10P0C10101
101111K001
10000001C1
1111111111
