1111111111
1C1K0001E1
1011110101
10P0C10101
1011110001
10000001C1
1111111111
