111111111111111111111111111111
101000P0C00010C000000000000C01
1C101111111110011111C111011101
1010000C110C11000011CCC101C101
10100111110C11111001CEC1000101
1010C100C00C1C001111CCC1111101
1000000010000000000000000000C1
111111111111111111111111111111
